1;70;70#2;65;2;1#4;86;2;1
2;70;135#1;65;2;1#3;50;2;1#5;86;2;1
3;70;185#2;50;2;1#6;86;4;1
4;156;70#1;86;2;1#5;65;2;1
5;156;135#2;86;2;1#4;65;2;1#6;50;2;1
6;156;185#3;86;4;1#5;50;2;1#11;104;4;1#51;50;2;1
7;210;70#8;65;2;1#9;50;2;1
8;210;135#7;65;2;1#10;50;2;1
9;260;70#7;50;2;1#10;65;2;1#12;60;2;1
10;260;135#8;50;2;1#9;65;2;1#11;50;2;1
11;260;185#6;104;4;1#10;50;2;1#14;60;2;1
12;320;70#9;60;2;1#13;65;6;1
13;320;135#12;65;6;1#14;50;6;1
14;320;185#11;60;4;1#13;50;6;1#16;60;4;1#59;50;6;1
15;380;135#16;50;2;1
16;380;185#15;50;2;1#14;60;4;1#19;86;4;1
17;466;70#18;65;2;1#20;104;2;1
18;466;135#17;65;2;1#19;50;2;1#21;104;2;1
19;466;185#16;86;4;1#18;50;2;1#22;104;4;1
20;570;70#17;104;2;1#21;65;2;1#23;60;2;1
21;570;135#18;104;2;1#20;65;2;1#22;50;2;1
22;570;185#19;104;4;1#21;50;2;1#25;60;4;1
23;630;70#20;60;2;1#24;65;6;1#26;60;2;1
24;630;135#23;65;6;1#25;50;6;1
25;630;185#22;60;4;1#24;50;6;1#28;60;4;1#73;50;6;1
26;690;70#23;60;2;1#27;65;2;1#29;146;2;1
27;690;135#26;65;2;1#28;50;2;1#30;146;2;1
28;690;185#25;60;4;1#27;50;2;1#31;146;4;1#76;50;2;1
29;836;70#26;146;2;1#30;65;2;1
30;836;135#27;146;2;1#29;65;2;1#31;50;2;1
31;836;185#28;146;4;1#30;50;2;1#33;50;4;1
32;886;135#33;50;2;1
33;886;185#31;50;4;1#32;50;2;1#36;56;4;1
34;940;70#35;65;6;1#37;60;2;1
35;940;135#34;65;6;1#36;50;6;1
36;940;185#33;56;4;1#35;50;6;1#39;60;4;1#88;50;6;1
37;1000;70#34;60;2;1#38;65;2;1#40;50;2;1
38;1000;135#37;65;2;1#39;50;2;1#41;50;2;1
39;1000;185#36;60;4;1#38;50;2;1#44;104;4;1
40;1050;70#37;50;2;1#41;65;2;1
41;1050;135#38;50;2;1#40;65;2;1
42;1104;70#43;65;2;1#45;86;2;1
43;1104;135#42;65;2;1#44;50;2;1#46;86;2;1
44;1104;185#39;104;4;1#43;50;2;1#47;86;4;1#96;50;2;1
45;1190;70#42;86;2;1#46;65;2;1
46;1190;135#43;86;2;1#45;65;2;1#47;50;2;1
47;1190;185#44;86;4;1#46;50;2;1
48;70;235#49;65;2;1#51;86;2;1
49;70;300#48;65;2;1#50;60;2;1#52;86;2;1
50;70;360#49;60;2;1#53;86;6;1#102;60;2;1
51;156;235#6;50;2;1#48;86;2;1#52;65;2;1
52;156;300#49;86;2;1#51;65;2;1#53;60;2;1
53;156;360#50;86;6;1#52;60;2;1#58;104;6;1#105;60;2;1
54;210;235#55;65;2;1#56;50;2;1
55;210;300#54;65;2;1#57;50;2;1
56;260;235#54;50;2;1#57;65;2;1#59;60;2;1
57;260;300#55;50;2;1#56;65;2;1#58;60;2;1
58;260;360#53;104;6;1#57;60;2;1#61;60;6;1#110;60;2;1
59;320;235#14;50;6;1#56;60;2;1#60;65;6;1#62;60;2;1
60;320;300#59;65;6;1#61;60;6;1
61;320;360#58;60;6;1#60;60;6;1#64;60;6;1#113;60;6;1
62;380;235#59;60;2;1#63;65;2;1#65;86;2;1
63;380;300#62;65;2;1#64;60;2;1#66;86;2;1
64;380;360#61;60;6;1#63;60;2;1#67;86;6;1#116;60;2;1
65;466;235#62;86;2;1#66;65;2;1
66;466;300#63;86;2;1#65;65;2;1#67;60;2;1
67;466;360#64;86;6;1#66;60;2;1#72;104;6;1#118;60;2;1
68;520;235#69;65;2;1#70;50;2;1
69;520;300#68;65;2;1#71;50;2;1
70;570;235#68;50;2;1#71;65;2;1#73;60;2;1
71;570;300#69;50;2;1#70;65;2;1#72;60;2;1
72;570;360#67;104;6;1#71;60;2;1#75;60;6;1#121;60;2;1
73;630;235#25;50;6;1#70;60;2;1#74;65;6;1
74;630;300#73;65;6;1#75;60;6;1
75;630;360#72;60;6;1#74;60;6;1#78;60;6;1#124;60;6;1
76;690;235#28;50;2;1#77;65;2;1#79;86;2;1
77;690;300#76;65;2;1#78;60;2;1#80;86;2;1
78;690;360#75;60;6;1#77;60;2;1#81;86;6;1#127;60;2;1
79;776;235#76;86;2;1#80;65;2;1
80;776;300#77;86;2;1#79;65;2;1#81;60;2;1
81;776;360#78;86;6;1#80;60;2;1#84;60;6;1
82;836;235#83;65;2;1#85;50;2;1
83;836;300#82;65;2;1#84;60;2;1#86;50;2;1
84;836;360#81;60;6;1#83;60;2;1#87;50;6;1#131;60;2;1
85;886;235#82;50;2;1#86;65;2;1#88;56;2;1
86;886;300#83;50;2;1#85;65;2;1
87;886;360#84;50;6;1#90;56;6;1#134;60;2;1
88;940;235#36;50;6;1#85;56;2;1#89;65;6;1#91;60;2;1
89;940;300#88;65;6;1#90;60;6;1
90;940;360#87;56;6;1#89;60;6;1#93;60;6;1#136;60;6;1
91;1000;235#88;60;2;1#92;65;2;1#94;50;2;1
92;1000;300#91;65;2;1#93;60;2;1#95;50;2;1
93;1000;360#90;60;6;1#92;60;2;1#98;104;6;1#139;60;2;1
94;1050;235#91;50;2;1#95;65;2;1
95;1050;300#92;50;2;1#94;65;2;1
96;1104;235#44;50;2;1#97;65;2;1#99;86;2;1
97;1104;300#96;65;2;1#98;60;2;1#100;86;2;1
98;1104;360;#93;104;6;1#97;60;2;1#101;86;6;1#144;60;2;1
99;1190;235#96;86;2;1#100;65;2;1
100;1190;300#97;86;2;1#99;65;2;1#101;60;2;1
101;1190;360#98;86;6;1#100;60;2;1#147;60;2;1
102;70;420#50;60;2;1#103;65;2;1#105;86;2;1
103;70;485#102;65;2;1#106;86;2;1
104;70;535#107;86;4;1#150;50;2;1
105;156;420#53;60;2;1#102;86;2;1#106;65;2;1
106;156;485#103;86;2;1#105;65;2;1#107;50;2;1
107;156;535#104;86;4;1#106;50;2;1#112;104;4;1#152;50;2;1
108;210;420#109;65;2;1#110;50;2;1
109;210;485#108;65;2;1#111;50;2;1
110;260;420#58;60;2;1#108;50;2;1#111;65;2;1
111;260;485#109;50;2;1#110;65;2;1#114;60;2;1
112;260;535#107;104;4;1#115;60;4;1#156;50;2;1
113;320;420#61;60;6;1#114;65;6;1
114;320;485#111;60;2;1#113;65;6;1#115;50;6;1
115;320;535#112;60;4;1#114;50;6;1#117;60;4;1#158;50;6;1
116;380;420#64;60;2;1
117;380;535#115;60;4;1#120;86;4;1
118;466;420#67;60;2;1#119;65;2;1#121;104;2;1
119;466;485#118;65;2;1#122;104;2;1
120;466;535#117;86;4;1#123;104;4;1#162;50;2;1
121;570;420#72;60;2;1#118;104;2;1#122;65;2;1
122;570;485#119;104;2;1#121;65;2;1#125;60;2;1
123;570;535#120;104;4;1#126;60;4;1#166;50;2;1
124;630;420#75;60;6;1#125;65;6;1
125;630;485#122;60;2;1#124;65;6;1#126;50;6;1
126;630;535#123;60;4;1#125;50;6;1#129;60;4;1#168;50;6;1
127;690;420#78;60;2;1#128;65;2;1#131;146;2;1
128;690;485#127;65;2;1#129;50;2;1#132;146;2;1
129;690;535#126;60;4;1#128;50;2;1#130;86;4;1
130;776;535#129;86;4;1#133;60;4;1#172;50;2;1
131;836;420#84;60;2;1#127;146;2;1#132;65;2;1
132;836;485#128;146;2;1#131;65;2;1
133;836;535#130;60;4;1#135;50;4;1#174;50;2;1
134;886;420#87;60;2;1
135;886;535#133;50;4;1#138;56;4;1
136;940;420#90;60;6;1#137;65;6;1
137;940;485#136;65;6;1#138;50;6;1#140;60;2;1
138;940;535#135;56;4;1#137;50;6;1#141;60;4;1#178;50;6;1
139;1000;420#93;60;2;1#140;65;2;1#142;50;2;1
140;1000;485#137;60;2;1#139;65;2;1#143;50;2;1
141;1000;535#138;60;4;1#146;104;4;1#180;50;2;1
142;1050;420#139;50;2;1#143;65;2;1
143;1050;485#140;50;2;1#142;65;2;1
144;1104;420#98;60;2;1#145;65;2;1#147;86;2;1
145;1104;485#144;65;2;1#146;50;2;1#148;86;2;1
146;1104;535#141;104;4;1#145;50;2;1#149;86;4;1#184;50;2;1
147;1190;420#101;60;2;1#144;86;2;1#148;65;2;1
148;1190;485#145;86;2;1#147;65;2;1
149;1190;535#146;86;4;1#186;50;2;1
150;70;585#104;50;2;1#151;65;2;1#152;86;2;1
151;70;650#150;65;2;1#153;86;2;1
152;156;585#107;50;2;1#150;86;2;1#153;65;2;1
153;156;650#151;86;2;1#152;65;2;1
154;210;585#155;65;2;1#156;50;2;1
155;210;650#154;65;2;1#157;50;2;1
156;260;585#112;50;2;1#154;50;2;1#157;65;2;1
157;260;650#155;50;2;1#156;65;2;1#159;60;2;1
158;320;585#115;50;6;1#159;65;6;1#160;60;2;1
159;320;650#157;60;2;1#158;65;6;1#161;60;2;1
160;380;585#158;60;2;1#161;65;2;1#162;86;2;1
161;380;650#159;60;2;1#160;65;2;1#163;86;2;1
162;466;585#120;50;2;1#160;86;2;1#163;65;2;1
163;466;650#161;86;2;1#162;65;2;1
164;520;585#165;65;2;1#166;50;2;1
165;520;650#164;65;2;1#167;50;2;1
166;570;585#123;50;2;1#164;50;2;1#167;65;2;1
167;570;650#165;50;2;1#166;65;2;1#169;60;2;1
168;630;585#126;50;6;1#169;65;6;1#170;60;2;1
169;630;650#167;60;2;1#168;65;6;1#171;60;2;1
170;690;585#168;60;2;1#171;65;2;1#172;86;2;1
171;690;650#169;60;2;1#170;65;2;1#173;86;2;1
172;776;585#130;50;2;1#170;86;2;1#173;65;2;1
173;776;650#171;86;2;1#172;65;2;1
174;836;585#133;50;2;1#175;65;2;1#176;50;2;1
175;836;650#174;65;2;1#177;50;2;1
176;886;585#174;50;2;1#177;65;2;1
177;886;650#175;50;2;1#176;65;2;1#179;56;2;1
178;940;585#138;50;6;1#179;65;6;1
179;940;650#177;56;2;1#178;65;6;1#181;60;2;1
180;1000;585#141;50;2;1#181;65;2;1#182;50;2;1
181;1000;650#179;60;2;1#180;65;2;1#183;50;2;1
182;1050;585#180;50;2;1#183;65;2;1
183;1050;650#181;50;2;1#182;65;2;1
184;1104;585#146;50;2;1#185;65;2;1#186;86;2;1
185;1104;650#184;65;2;1#187;86;2;1
186;1190;585#149;50;2;1#184;86;2;1#187;65;2;1
187;1190;650#185;86;2;1#186;65;2;1